world_x = 16
world_y = 12
#################
#####.......#####
###...........###
.................
.......##........
.......###.......
.....###.........
.................
.................
#############...#
#...............#
#################